111111111111111111111
1E0000000000000C00C01
101001010010000101001
101001001010100001001
1P0000000C00C00000001
101001001010010001001
111111111111111111111