111111111111111111111
1E000000E000000000001
101001010010000101001
101001001010100001001
1P00000000000C0000001
10100100P010010EE1001
111111111111111111111