11111111111111
1E000CC0000001
10100010010101
1P0000000000C1
11111111111111