111111111111111111111111111111111111111111
10000CC000000110000CC000000000000CC0000001
10100010010101100000000000C0000000000000C1
100000000000C1100000000000C1100000000000C1
100000000000C1100000000000C1100010000000C1
100000000000C0000000010000C0000000000000C1
1E000CC0000001100000010000C1100010000000C1
10100010010101100000010000C1100000000000C1
1P0000000000C1100000000000C1100010000000C1
111111111111111111111111111111111111111111